[
  {
    "type": "mapgen",
    "method": "json",
    "om_terrain": [ "frozen_cave" ],
    "weight": 1000,
    "object": {
      "rotation": [ 0, 3 ],
      "rows": [
        "........................",
        "........................",
        "........................",
        "........................",
        "........................",
        "........................",
        "........................",
        "........................",
        "........................",
        "........%%%%%%%%%.......",
        ".......%%|||||||%%......",
        ".......%|||||||||%......",
        ".......%||||,,<||%......",
        ".......%|||,,||||%......",
        ".......%|||,,||||%......",
        ".......%%|||,,||%%......",
        "........%%%%;;%%%.......",
        "........................",
        "........................",
        "........................",
        "........................",
        "........................",
        "........................",
        "........................"
      ],
      "terrain": {
        ".": [ [ "t_region_groundcover_forest", 4 ], [ "t_region_tree", 1 ] ],
        "|": "t_rock",
        ",": "t_rock_roof",
        "%": [ "t_rock", "t_region_groundcover_forest" ],
        ";": "t_dirt",
        "<": "t_slope_down"
      },
      "items": { ",": [ { "item": "cave_minerals", "chance": 5 } ] }
    }
  },
  {
    "type": "mapgen",
    "method": "json",
    "om_terrain": [ "frozen_cave" ],
    "weight": 1000,
    "object": {
      "rotation": [ 0, 3 ],
      "rows": [
        "........................",
        "........................",
        "........................",
        ".....%%%%%%%%%%%%%%%....",
        "....%||||||||||||||%%...",
        "....%|,,,,,,,,,,,,||%...",
        "....%|,,,||||||||,,|%...",
        "....%|,,|||||||||,,|%...",
        "....%|<||,,,,||||,,|%...",
        "....%|||,,||,,|||,,|%...",
        "....%|||,,|||,,,,,,|%...",
        "....%|||,,||||||||||%...",
        "....%|||,,,,,,||||||%...",
        "....%|||,,|||,,|||||%...",
        "....%|||,,||||,,||||%...",
        "....%||,,,|||||,,|||%...",
        "....%|,,,,|||||,,|||%...",
        "....%||||||,,,,,,|||%...",
        "....%|||||,,||||||||%...",
        "....%%|||;;||||||||%%...",
        ".....%%%%;;%%%%%%%%%....",
        "........................",
        "........................",
        "........................"
      ],
      "terrain": {
        ".": [ [ "t_region_groundcover_forest", 4 ], [ "t_region_tree", 1 ] ],
        "|": "t_rock",
        "%": [ "t_rock", "t_region_groundcover_forest" ],
        ";": "t_dirt",
        ",": "t_rock_roof",
        "<": "t_slope_down"
      },
      "furniture": {  },
      "items": { ",": [ { "item": "cave_minerals", "chance": 5 } ] }
    }
  },
  {
    "type": "mapgen",
    "method": "json",
    "om_terrain": [ "frozen_cave" ],
    "weight": 1000,
    "object": {
      "rotation": [ 0, 3 ],
      "rows": [
        "........................",
        "........................",
        "........................",
        ".....%%%%%%%%%%%%%%%....",
        "....%||||||||||||||%%...",
        "....%|,,,WW,,,,WW,||%...",
        "....%|,,,||||||||,,|%...",
        "....%|WW|||||||||,,|%...",
        "....%|<||W,,,||||,,|%...",
        "....%|||,W||,,|||,,|%...",
        "....%|||,,|||,,,W,,|%...",
        "....%|||,,||||||||||%...",
        "....%|||,,,W,,||||||%...",
        "....%|||,,|||,,|||||%...",
        "....%|||,,||||,W||||%...",
        "....%||WWW|||||W,|||%...",
        "....%|WWWW|||||,,|||%...",
        "....%||||||,,,,,,|||%...",
        "....%|||||,,||||||||%...",
        "....%%|||;;||||||||%%...",
        ".....%%%%;;%%%%%%%%%....",
        "........................",
        "........................",
        "........................"
      ],
      "terrain": {
        ".": [ [ "t_region_groundcover_forest", 4 ], [ "t_region_tree", 1 ] ],
        "|": "t_rock",
        "%": [ "t_rock", "t_region_groundcover_forest" ],
        ";": "t_dirt",
        ",": "t_rock_roof",
        "W": "t_rock_roof",
        "<": "t_slope_down"
      },
      "furniture": {  },
      "fields": { "W": { "field": "fd_web", "intensity": 2, "age": 10 } },
      "monsters": { "W": { "monster": "GROUP_WINTER_ZOMBIE_UPGRADE", "chance": 20, "density": 0.02 } },
      "items": { ",": [ { "item": "cave_minerals", "chance": 5 } ] }
    }
  },
  {
    "type": "mapgen",
    "method": "json",
    "om_terrain": [ "frozen_cave" ],
    "weight": 1000,
    "object": {
      "rotation": [ 0, 3 ],
      "rows": [
        "........................",
        "........................",
        "........................",
        ".....%%%%%%%%%%%%%%%....",
        "....%||||||||||||||%%...",
        "....%|,||||,,,W,||||%...",
        "....%|,,||,,|||,,|||%...",
        "....%||,,,,|||||,,||%...",
        "....%||||||||,,W,,||%...",
        "....%|,|,,,,||||,,||%...",
        "....%|,|W||,,||||,,,;...",
        "....%,,|,,||,<|||,,,;...",
        "....%|W||,,||||,,,||%...",
        "....%|,,||,,|||,,|||%...",
        "....%||,,||,,W,,||,|%...",
        "....%|||,,|,|||,||,|%...",
        "....%||||,,,|||,,W,|%...",
        "....%||||,||||||||||%...",
        "....%|||,,,,W,,,,,||%...",
        "....%%|||||||||||||%%...",
        ".....%%%%%%%%%%%%%%%....",
        "........................",
        "........................",
        "........................"
      ],
      "terrain": {
        ".": [ [ "t_region_groundcover_forest", 4 ], [ "t_region_tree", 1 ] ],
        "|": "t_rock",
        "%": [ "t_rock", "t_region_groundcover_forest" ],
        ";": "t_dirt",
        ",": "t_rock_roof",
        "W": "t_rock_roof",
        "<": "t_slope_down"
      },
      "monsters": { "W": { "monster": "GROUP_WINTER_ZOMBIE_UPGRADE", "chance": 20, "density": 0.02 } },
      "furniture": {  },
      "items": { ",": [ { "item": "cave_minerals", "chance": 5 } ] }
    }
  },
  {
    "type": "mapgen",
    "method": "json",
    "om_terrain": [ "frozen_cave" ],
    "weight": 1000,
    "object": {
      "rotation": [ 0, 3 ],
      "rows": [
        "........................",
        "........................",
        "........................",
        ".....%%%%%%%%%%%%%%%....",
        "....%||||||||||||||%%...",
        "....%|,||||,,,,B||||%...",
        "....%|,,||BB|||B,|||%...",
        "....%||,,,,|||||,,||%...",
        "....%||||||||,,B,,||%...",
        "....%|,|,,,,||||,,||%...",
        "....%|,|,||,,||||,,,;...",
        "....%,,|BB||,<|||,,,;...",
        "....%|,||,,||||,,,||%...",
        "....%|,B||,,|||,,|||%...",
        "....%||,,||,BBB,||,|%...",
        "....%|||,,|,|||,||,|%...",
        "....%||||,,,|||,,,,|%...",
        "....%||||,||||||||||%...",
        "....%|||BB,,,,,,,,||%...",
        "....%%|||||||||||||%%...",
        ".....%%%%%%%%%%%%%%%....",
        "........................",
        "........................",
        "........................"
      ],
      "terrain": {
        ".": [ [ "t_region_groundcover_forest", 4 ], [ "t_region_tree", 1 ] ],
        "|": "t_rock",
        "%": [ "t_rock", "t_region_groundcover_forest" ],
        ";": "t_dirt",
        ",": "t_rock_roof",
        "B": "t_rock_roof",
        "<": "t_slope_down"
      },
      "furniture": {  },
      "monster": { "B": { "monster": "mon_ice_elemental", "chance": 10 } },
      "items": { ",": [ { "item": "cave_minerals", "chance": 5 } ] }
    }
  },
  {
    "type": "mapgen",
    "method": "json",
    "om_terrain": [ "cave" ],
    "weight": 1000,
    "object": {
      "rotation": [ 0, 3 ],
      "rows": [
        "........................",
        "........................",
        "........................",
        ".....%%%%%%%%%%%%%%%....",
        "....%||||||||||||||%%...",
        "....%|,||||,,W,,||||%...",
        "....%|,,||,,|||,,|||%...",
        "....%||,,W,|||||,,||%...",
        "....%||||||||,,,,,||%...",
        "....%|,|,,,,||||,,||%...",
        "....%|W|,||,B||||,,,;...",
        "....%,,|,,||,<|||,,,;...",
        "....%|,||,,||||,,,||%...",
        "....%|,,||,,|||,,|||%...",
        "....%||,,||,,,,,||,|%...",
        "....%|||,,|,|||W||,|%...",
        "....%||||,W,|||,,,,|%...",
        "....%||||,||||||||||%...",
        "....%|||,,,,,,,W,,||%...",
        "....%%|||||||||||||%%...",
        ".....%%%%%%%%%%%%%%%....",
        "........................",
        "........................",
        "........................"
      ],
      "terrain": {
        ".": [ [ "t_region_groundcover_forest", 4 ], [ "t_region_tree", 1 ] ],
        "|": "t_rock",
        "%": [ "t_rock", "t_region_groundcover_forest" ],
        ";": "t_dirt",
        ",": "t_rock_roof",
        "B": "t_rock_roof",
        "W": "t_rock_roof",
        "<": "t_slope_down"
      },
      "furniture": {  },
      "fields": { "W": { "field": "fd_web", "intensity": 1, "age": 10 } },
      "monster": { "B": { "monster": "mon_ice_demon" } },
      "items": { ",": [ { "item": "cave_minerals", "chance": 5 } ] }
    }
  },
  {
    "type": "mapgen",
    "method": "json",
    "om_terrain": [ "frozen_cave" ],
    "weight": 1000,
    "object": {
      "rotation": [ 0, 3 ],
      "rows": [
        "........................",
        ".........%%%%%%%........",
        "........%|||||||%.......",
        ".......%|||||||||%......",
        "......%|||||,,,,||%.....",
        ".....%||||||W||,,||%....",
        "....%||,,,,,,|||,,||%...",
        "...%||,,||||,,|||,,||%..",
        "..%|||W||||||,,|||,,||%.",
        ".%||||,,,,,|||,,|||<||%.",
        ".%|||||||||||||,,|||||%.",
        ".%||||,,,,,,W,,,,,,,,,;.",
        ".%|||,,|||,||,,,,,,,,,;.",
        ".%||,,||||,|||,,,,,|||%.",
        ".%||W|||||,||||,,,||||%.",
        "..%|||,|||W|||||,|||||%.",
        "...%||,,||,,,||||||||%..",
        "....%||,,|||,,||||||%...",
        ".....%||,,|||,,||||%....",
        "......%||,,|||,,||%.....",
        ".......%||,,W,,||%......",
        "........%|||||||%.......",
        ".........%%%%%%%........",
        "........................"
      ],
      "terrain": {
        ".": [ [ "t_region_groundcover_forest", 4 ], [ "t_region_tree", 1 ] ],
        "|": "t_rock",
        "%": [ "t_rock", "t_region_groundcover_forest" ],
        ";": "t_dirt",
        ",": "t_rock_roof",
        "B": "t_rock_roof",
        "W": "t_rock_roof",
        "<": "t_slope_down"
      },
      "fields": { "W": { "field": "fd_web", "intensity": 1, "age": 10 } },
      "furniture": {  },
      "items": { ",": [ { "item": "cave_minerals", "chance": 5 } ] }
    }
  },
  {
    "type": "mapgen",
    "method": "json",
    "om_terrain": [ "frozen_cave" ],
    "weight": 1000,
    "object": {
      "rotation": [ 0, 3 ],
      "rows": [
        "........................",
        ".........%%%%%%%........",
        "........%|||||||%.......",
        ".......%|||||||||%......",
        "......%|||||,,W,||%.....",
        ".....%||||||,||,,||%....",
        "....%||,,W,,,|||,,||%...",
        "...%||,,||||,,|||,W||%..",
        "..%|||,||||||,,|||,,||%.",
        ".%||||,,W,,|||,,|||<||%.",
        ".%|||||||||||||,,|||||%.",
        ".%||||,,,,,W,,,,,,,,,,;.",
        ".%|||,,|||,||,,,,,,,,,;.",
        ".%||,,||||,|||,,,,,|||%.",
        ".%||W|||||,||||,B,||||%.",
        "..%|||,|||,|||||B|||||%.",
        "...%||,,||,W,||||||||%..",
        "....%||,,|||,,||||||%...",
        ".....%||,,|||,,||||%....",
        "......%||,,|||,,||%.....",
        ".......%||,,W,,||%......",
        "........%|||||||%.......",
        ".........%%%%%%%........",
        "........................"
      ],
      "terrain": {
        ".": [ [ "t_region_groundcover_forest", 4 ], [ "t_region_tree", 1 ] ],
        "|": "t_rock",
        "%": [ "t_rock", "t_region_groundcover_forest" ],
        ";": "t_dirt",
        ",": "t_rock_roof",
        "B": "t_rock_roof",
        "W": "t_rock_roof",
        "<": "t_slope_down"
      },
      "furniture": {  },
      "fields": { "W": { "field": "fd_web", "intensity": 1, "age": 10 } },
      "monster": { "B": { "monster": "mon_ice_elemental" } },
      "items": { ",": [ { "item": "cave_minerals", "chance": 5 } ] }
    }
  },
  {
    "type": "mapgen",
    "method": "json",
    "om_terrain": [ "frozen_cave_underground" ],
    "weight": 50,
    "object": {
      "rotation": [ 0, 3 ],
      "rows": [
        "........................",
        ".......~~~~~~~~~~~......",
        "......~~~~~~~~~~~~~.....",
        "......~~~~~~~~~~~~~.....",
        "......~~~~......~~~.....",
        ".....~~~~~~.<...~~~.....",
        "....~~~~~~~~....~~~~....",
        "......~~~~~~~..~~~~~....",
        "....~~~~W~~~..~~~~~~....",
        "....~~~~~~~~..~~~~~.....",
        ".....~~~~~~~..~~~~~.....",
        "..............~~~~~~....",
        "............~~~~~~~.....",
        "...........~~~~~~~......",
        "....~~~~~~~~~~~~~~~~....",
        ".....~~~~~~~~~~~~~~.....",
        ".......~~~~~~~~~~~......",
        ".......~~~~~~~~~~~......",
        "........~~~~~~~~~~......",
        ".........~~~~~~~~.......",
        "..........~~~~~~~.......",
        "............,...........",
        "............>...........",
        "........................"
      ],
      "terrain": { ".": "t_rock", ",": "t_rock_floor", "W": "t_rock_floor", ">": "t_slope_up", "<": "t_slope_down", "~": "t_water_sh" },
      "furniture": { "W": "f_boulder_small" },
      "items": { "W": { "item": "swords_caliburn", "chance": 100 } },
      "place_loot": [
        { "item": "sq_dragon_warning_note", "x": 12, "y": 5 }, { "item": "sq_frozen_shards", "x": 12, "y": 5, "repeat": [ 1, 5 ] }, { "item": "bone_human", "x": 12, "y": 5, "repeat": [ 1, 5 ] }
      ],
      "monster": {
        "~": [
          { "monster": "mon_sewer_fish", "chance": 1 },
          { "monster": "mon_mutant_salmon", "chance": 1 },
          { "monster": "mon_mutant_carp", "chance": 1 }
        ]
      },
      "nested": { ",": { "chunks": [ [ "null", 7 ], [ "place_cave_moss", 1 ] ] } }
    }
  },
  {
    "type": "mapgen",
    "method": "json",
    "om_terrain": [ "frozen_cave_underground" ],
    "weight": 100,
    "object": {
      "fill_ter": "t_rock_floor",
      "rotation": [ 0, 3 ],
      "rows": [
        "........................",
        "........................",
        "........................",
        "........................",
        "........................",
        "................ccc.....",
        "...............C   h....",
        "...............C   e....",
        "................. ......",
        ".........<        ......",
        ".......... %%% .........",
        "..........%%%%%.........",
        "............%...........",
        "..........%%%%%.........",
        ".........  %%%   .......",
        ".........        .......",
        "..........      ........",
        "..........      ........",
        "...........    .........",
        "...........    .........",
        "...........   ..........",
        "............>...........",
        "........................",
        "........................"
      ],
      "terrain": { ".": "t_rock", ">": "t_slope_up", "<": "t_slope_down" },
      "furniture": {
        "%": [ [ "f_rubble_rock", 7 ], [ "f_boulder_small", 2 ], "f_boulder_medium" ],
        "C": "f_crate_c",
        "c": "f_chest",
        "e": "f_desk",
        "h": "f_chair"
      },
      "place_loot": [
        { "item": "sq_dragon_warning_note", "x": 9, "y": 9 }, { "item": "sq_frozen_shards", "x": 9, "y": 9, "repeat": [ 1, 5 ] }, { "item": "bone_human", "x": 9, "y": 9, "repeat": [ 1, 5 ] }
      ],
      "item": { "e": [ { "item": "candle", "chance": 25 }, { "item": "waterwaymap", "chance": 10 } ] },
      "items": {
        " ": { "item": "cave_minerals", "chance": 5 },
        "C": { "item": "supplies_naval_cache", "chance": 100 },
        "c": [
          { "item": "jewelry_safe", "chance": 100 },
          { "item": "jewelry_safe", "chance": 75 },
          { "item": "jewelry_safe", "chance": 50 }
        ]
      },
      "nested": { " ": { "chunks": [ [ "null", 7 ], [ "place_cave_moss", 1 ] ] } },
      "monsters": { " ": { "monster": "GROUP_CAVE", "chance": 2 } }
    }
  },
  {
    "type": "mapgen",
    "method": "json",
    "nested_mapgen_id": "random_bandit_spawn",
    "object": { "mapgensize": [ 1, 1 ], "place_npcs": [ { "class": "bandit", "x": 0, "y": 0 } ] }
  },
  {
    "type": "mapgen",
    "method": "json",
    "om_terrain": [ "cave_underground" ],
    "weight": 800,
    "object": {
      "fill_ter": "t_rock_floor",
      "rotation": [ 0, 3 ],
      "rows": [
        "........................",
        "........................",
        "...............~~~~~~...",
        "..............~~~~~~~~..",
        ".............<~~~~~~~~..",
        "............~~~~~~~~~~..",
        "...........~~~~~~~~~~~..",
        "...........~~~~~~~~~~~..",
        "...........~~~~~~~~~~...",
        ".........~~~~~~~~.......",
        "..~~~~~~~~~~~~~~~.......",
        "....~~~~~~~~~~~~~~~~~~..",
        "..~~~~~~~~~~~~~~~~~~~~~.",
        "..~~~~~~~~~~~~~~~~~~~~~.",
        "...~~~~~~~~~~~~~~~~~~~..",
        "....~~~~~~~~~~~~........",
        "....~~~~~.,,,,,.........",
        "..~~~~~~~..,,,..........",
        "..~~~~~~~...,...........",
        "...~~~~~~...,...........",
        ".....~~~....,...........",
        "............,...........",
        "............>...........",
        "........................"
      ],
      "terrain": { ".": "t_rock", ",": "t_rock_floor", ">": "t_slope_up", "<": "t_slope_down" },
      "furniture": {  },
      "place_loot": [
        { "item": "sq_dragon_warning_note", "x": 13, "y": 4 }, { "item": "sq_frozen_shards", "x": 13, "y": 4, "repeat": [ 1, 5 ] }, { "item": "bone_human", "x": 13, "y": 4, "repeat": [ 1, 5 ] }
      ],
      "items": { "~": [ { "item": "monparts", "chance": 2 }, { "item": "trash_forest", "chance": 2 } ] },
      "nested": {
        ",": { "chunks": [ [ "null", 7 ], [ "place_cave_moss", 1 ] ] },
        "~": { "chunks": [ [ "null", 7 ], [ "place_cave_moss", 1 ] ] }
      }
    }
  },
  {
    "type": "mapgen",
    "method": "json",
    "om_terrain": [ "frozen_cave_underground" ],
    "weight": 500,
    "object": {
      "fill_ter": "t_rock_floor",
      "rotation": [ 0, 3 ],
      "rows": [
        "........................",
        "........................",
        "...........!!G!!G.......",
        ".........S!!!!!!!G......",
        ".........S!!!GG!!!......",
        ".........!!!!!!!!G......",
        ".......G!!,,CC,,!.......",
        "........G!!!..,,,!......",
        ".........G!,.<,,,!G.....",
        "..........,,,,,,,!......",
        "..........,,,,,,,.......",
        "..........,,,,,,,.......",
        "..........,,,,,,,.......",
        ".........,,,,.CC,.......",
        ".........,,,,...,.......",
        ".........,,,,...,.......",
        ".........,,,,...,.......",
        ".........,,,,...,.......",
        ".........,,,,...,.......",
        ".........,,,,..,,.......",
        ".........,,,>.,,........",
        "..........,,.,,.........",
        "...........,,,..........",
        "........................"
      ],
      "terrain": { ".": "t_rock", ",": "t_rock_floor", "!": "t_rock_floor", ">": "t_slope_up", "<": "t_slope_down" },
      "furniture": { "C": "f_crate_c", "S": "f_utility_shelf", "G": [ "f_grave_stone_old", "f_grave_head", "f_grave_monument" ] },
      "place_loot": [
        { "item": "sq_dragon_warning_note", "x": 13, "y": 8 }, { "item": "sq_frozen_shards", "x": 13, "y": 8, "repeat": [ 1, 5 ] }, { "item": "bone_human", "x": 13, "y": 8, "repeat": [ 1, 5 ] }
      ],
      "item": {
        "!": { "item": "material_soil", "chance": 40, "amount": [ 5, 10 ] },
        "C": { "item": "dynamite", "chance": 40, "repeat": 2 }
      },
      "items": { "S": { "item": "archeology_tools", "chance": 90, "repeat": [ 1, 2 ] } },
      "nested": { ",": { "chunks": [ [ "null", 7 ], [ "place_cave_moss", 1 ] ] } }
    }
  },
  {
    "type": "mapgen",
    "method": "json",
    "om_terrain": [ "frozen_cave_dragon" ],
    "object": {
      "fill_ter": "t_rock_floor",
      "rotation": [ 0, 3 ],
      "rows": [
        "........................",
        ".........%%%%%%%........",
        "........%%%%%%%%%.......",
        ".......%%%.....%%%......",
        "......%%||.lll.||%%.....",
        ".....%||||ll ll||||%....",
        "....%|||||ll ll|||||%...",
        "...||||||l. K .l||||||..",
        "||||r              r||||",
        "|||                  |||",
        "|||                  |||",
        "|||                  |||",
        "|||                  |||",
        "|||                  |||",
        "|||                  |||",
        "|||                  |||",
        "|||                  |||",
        "|||                  |||",
        "|||                  |||",
        "||||                ||||",
        "|||||              |||||",
        "|||||||          |||||||",
        "||||||||||||<|||||||||||",
        "||||||||||||||||||||||||"
      ],
      "terrain": {
        " ": "t_rock_floor",
        ".": "t_rock",
        "|": [ [ "t_rock", 30 ], [ "t_rock_floor", 70 ] ],
        "%": [ "t_rock", "t_rock_floor" ],
        "<": "t_slope_up"
      },
      "furniture": {  },
      "monster": { "K": { "monster": "mon_dragon_permafrost" }, "r": { "monster": "mon_ice_elemental" } },
      "place_loot": [
        { "item": "sq_recipe_book_frost_melee", "x": 12, "y": 5 }
      ],
      "item": {
        "l": { "item": "bone_human", "chance": 95, "amount": [ 5, 20 ] }
      },
      "items": {
		"l": { "item": "military", "chance": 75 },
        " ": { "item": "bone_human", "chance": 8 }
      },
      "nested": { " ": { "chunks": [ [ "null", 7 ], [ "place_cave_moss", 1 ] ] } }
    }
  },
  {
    "id": "archeology_tools",
    "type": "item_group",
    "subtype": "collection",
    "entries": [
      { "item": "pickaxe", "prob": 75 },
      { "item": "paint_brush", "prob": 75 },
      { "item": "hammer", "prob": 75 },
      { "item": "chipper", "prob": 75 },
      { "item": "g_shovel", "prob": 75 },
      { "item": "stepladder", "prob": 50 },
      { "item": "cavemap", "prob": 50 },
      { "item": "miner_hat", "prob": 75 }
    ]
  }
]